#####################
#O........  #   #   #
# #######.##### # # #
#     #...#     # # #
##### #.### ##### # #
# #   #...# #     # #
# # #####.# ##### # #
# #     #.#       # #
# ##### #.######### #
#       #...  #   #X#
# #########.# # ### #
#     #.....#   #   #
# #####.####### # ###
# #...#.# #   # # # #
###.#.#.# # # # # # #
#...#.#.#   #   # # #
#.###.#.##### ### # #
#...#...#...#   # # #
# #.#####.#.##### # #
# #.......#........ #
#####################
