#####################
#O          #   #   #
# ####### ##### # # #
#     #   #     # # #
##### # ### ##### # #
# #   #   # #     # #
# # ##### # ##### # #
# #     # #       # #
# ##### # ######### #
#       #     #   #X#
# ######### # # ### #
#     #     #   #   #
# ##### ####### # ###
# #   # # #   # # # #
### # # # # # # # # #
#   # # #   #   # # #
# ### # ##### ### # #
#   #   #   #   # # #
# # ##### # ##### # #
# #       #         #
#####################
